1111111111
1000000001
1101101111
1101100011
1000101111
1101100001
1001101111
1100100011
1110001211
1111111111
