1111111111
1000000001
1111101111
1110000011
1101101111
1100000001
1111101111
1120101111
1110001111
1111111111
