1111111111
1000011111
1111000001
1000011101
1101010111
1001000001
1101011101
1001012001
1100001111
1111111111
